NO textures/bathroom/purple.xpm
SO textures/bathroom/green.xpm
WE textures/bathroom/red.xpm
EA textures/bathroom/purple.xpm

C 153,204,255





F     32,  169,    76 
111111111111111111111
101000001000000000001
101000001000000100001
10000101E000000000001
111111111111111111111

