





     NO                             textures/simonkraft/respawn_anchor_side0.xpm
                 SO textures/simonkraft/respawn_anchor_side4.xpm
           WE                                                                         textures/simonkraft/respawn_anchor_side3.xpm 



              EA textures/simonkraft/respawn_anchor_side2.xpm


F 20, 20, 20
C 200, 200, 200



11111 111                                 111111111                      
111111000111111
111110000011111
111100N00001111
111000000001111
1100000000000011
100001111101001
110000111000011
111000010000111
111100000001111
111110000011111
111111000111111
111111111111111
111111111 111 11111111    111  
1111   101   1001   1
1111111111111111