





     NO textures/simonkraft/respawn_anchor_side0.xpm
                 SO textures/simonkraft/respawn_anchor_side4.xpm
           WE textures/simonkraft/respawn_anchor_side3.xpm 



     F 123               , 221,                  254
              EA textures/simonkraft/respawn_anchor_side2.xpm
      C 181,    222       ,              123





11111 111     111111111                      
111111000111111
111110000011111
111100000001111
111000000000111
110000000000011
100001111100001
110000111000011
111000010000111
111100000001111
111110000011111
111111000111111
111111111111111
111111111   1111111    111  
1111111111111111