NO bruh dasdasdasd
      SO hello dadad
                EA bananan dadasdasd


WE cheeese

F 133  , 31,     31     
C 123  ,     31,       123    
  
11111111111111111
100000N0000000001
10000000000000001
11111111111111111