NO bruh dasdasdasd
      SO hello dadad
                EA bananan dadasdasd

C 12   ,   1,    2  

WE cheeese

F 133   ,    22       , 2   

 1 1 1 11 1 11 
101S10100101001
111111111111111