NO bruh dasdasdasd
      SO hello dadad
                EA bananan dadasdasd


WE cheeese

F 133   ,    22       , 2   
C 12   ,   1,    2  

      1
111111S1111111111
      1

      1